00000000
000w0000
000w0000
000w0w00
000www00
00000000
0w000000
0w00000x
